10 22
%%%%%%%%%%%%%%%%%%%%%%
%_%%________%_%______%
%____%%%%%%_%_%%%%%%_%
%%%%%%_____P__%______%
%____%_%%%%%%_%%_%%%%%
%_%%%%_%_________%___%
%________%%%_%%%___%_%
%%%%%%%%%%____%%%%%%_%
%._________%%________%
%%%%%%%%%%%%%%%%%%%%%%
